MODE 3
SIZE 9/11
LIMIT 0/20
COLOR LIMIT 5
STARS 2500/3200/5000
COLLECT COUNT 0/0
COLLECT ITEMS 0/0
10 10 10 10 10 10 10 10 10
10 10 10 10 20 10 10 10 10
10 10 20 20 20 20 20 10 10
10 10 20 20 20 20 20 10 10
10 10 20 20 10 20 20 10 10
10 20 20 20 10 20 20 20 10
10 10 20 20 10 20 20 10 10
10 10 20 20 10 20 20 10 10
10 10 20 20 20 20 20 10 10
10 10 10 10 20 10 10 10 10
10 10 10 10 10 10 10 10 10