MODE 3
SIZE 9/9
LIMIT 0/19
COLOR LIMIT 5
STARS 1000/2500/3800
COLLECT COUNT 0/0
COLLECT ITEMS 1/2
10 10 10 10 10 10 10 10 10
10 20 20 10 10 10 20 20 10
10 20 20 10 10 10 20 20 10
10 10 10 10 20 10 10 10 10
10 10 10 20 20 20 10 10 10
10 10 10 10 20 10 10 10 10
10 20 20 10 10 10 20 20 10
10 20 20 10 10 10 20 20 10
10 10 10 10 10 10 10 10 10