MODE 3
SIZE 9/11
LIMIT 0/28
COLOR LIMIT 4
STARS 5000/7500/10000
COLLECT COUNT 0/0
COLLECT ITEMS 1/2
20 20 20 20 20 20 20 20 20
20 20 20 20 20 20 20 20 20
20 20 20 20 20 20 20 20 20
00 00 00 00 00 00 00 00 00
20 20 20 20 20 20 20 20 20
20 20 20 20 20 20 20 20 20
20 20 20 20 20 20 20 20 20
00 00 00 00 00 00 00 00 00
20 20 20 20 20 20 20 20 20
20 20 20 20 20 20 20 20 20
20 20 20 20 20 20 20 20 20