MODE 1
SIZE 8/6
LIMIT 0/29
COLOR LIMIT 4
STARS 1000/2500/3800
COLLECT COUNT 25/35
COLLECT ITEMS 2/5
10 10 10 10 10 10 10 10
10 10 10 10 10 10 10 10
10 10 10 10 10 10 10 10
10 10 14 14 14 14 10 10
14 14 14 10 10 14 14 14
14 14 14 10 10 14 14 14