MODE 3
SIZE 9/10
LIMIT 0/25
COLOR LIMIT 5
STARS 4100/5200/6300
COLLECT COUNT 0/0
COLLECT ITEMS 1/2
10 10 10 10 10 10 10 10 10
10 10 10 10 10 10 10 10 10
10 10 10 10 10 10 10 10 10
10 10 10 10 10 10 10 10 10
10 10 10 10 10 10 10 10 10
10 14 10 14 10 14 10 14 10
10 14 10 14 10 14 10 14 10
14 14 14 14 14 14 14 14 14
10 14 10 14 10 14 10 14 10
14 10 14 10 14 10 14 10 14