MODE 3
SIZE 9/11
LIMIT 0/35
COLOR LIMIT 4
STARS 8900/12000/13900
COLLECT COUNT 0/0
COLLECT ITEMS 1/2
10 10 10 14 50 14 10 10 10
10 10 10 14 50 14 10 10 10
10 10 10 14 50 14 10 10 10
10 10 10 14 50 14 10 10 10
10 10 10 14 50 14 10 10 10
10 10 10 14 50 14 10 10 10
10 10 10 14 50 14 10 10 10
14 14 14 14 50 14 14 14 14
50 50 50 14 50 14 50 50 50
50 50 50 14 50 14 50 50 50
50 50 50 14 50 14 50 50 50