MODE 1
SIZE 9/11
LIMIT 0/27
COLOR LIMIT 4
STARS 5400/8000/10000
COLLECT COUNT 25/30
COLLECT ITEMS 4/5
10 10 10 10 10 10 10 10 10
10 10 10 10 10 10 10 10 10
10 10 10 10 10 10 10 10 10
14 14 14 14 14 14 14 14 14
13 13 13 13 13 13 13 13 13
13 13 13 13 13 13 13 13 13
13 13 13 13 13 13 13 13 13
14 14 14 14 14 14 14 14 14
50 50 50 50 50 50 50 50 50
50 50 50 50 50 50 50 50 50
50 50 50 50 50 50 50 50 50