MODE 3
SIZE 9/11
LIMIT 0/29
COLOR LIMIT 5
STARS 4500/6350/8800
COLLECT COUNT 0/0
COLLECT ITEMS 1/2
20 20 20 20 20 20 20 20 20
20 10 10 10 20 10 10 10 20
20 10 10 10 20 10 10 10 20
20 10 10 10 20 10 10 10 20
20 10 10 10 20 10 10 10 20
20 20 20 20 20 20 20 20 20
20 10 10 10 20 10 10 10 20
20 10 10 10 20 10 10 10 20
20 10 10 10 20 10 10 10 20
20 10 10 10 20 10 10 10 20
20 20 20 20 20 20 20 20 20