MODE 3
SIZE 9/11
LIMIT 0/21
COLOR LIMIT 5
STARS 4200/5000/6900
COLLECT COUNT 0/0
COLLECT ITEMS 1/2
10 10 10 10 10 10 10 10 10
10 10 10 10 10 10 10 10 10
10 10 00 00 14 50 50 10 10
10 10 00 00 14 50 50 10 10
10 10 50 50 14 50 50 10 10
10 10 50 50 14 50 50 10 10
10 10 14 14 14 14 14 10 10
10 10 50 50 14 50 50 10 10
10 10 50 50 14 00 00 10 10
10 10 50 50 14 00 00 10 10
10 10 10 10 10 10 10 10 10