MODE 1
SIZE 9/11
LIMIT 0/18
COLOR LIMIT 4
STARS 1000/1700/3000
COLLECT COUNT 15/25
COLLECT ITEMS 1/4
10 10 10 10 10 10 10 10 10
10 10 10 10 10 10 10 10 10
10 10 10 10 10 10 10 10 10
10 10 10 10 10 10 10 10 10
10 10 10 10 10 10 10 10 10
14 14 14 13 13 13 14 14 14
14 14 14 13 13 13 14 14 14
13 14 14 14 14 14 14 14 13
14 14 13 14 14 14 13 14 14
14 14 14 14 13 14 14 14 14
14 14 14 13 13 13 14 14 14