MODE 3
SIZE 9/9
LIMIT 0/23
COLOR LIMIT 4
STARS 7000/9500/13000
COLLECT COUNT 0/0
COLLECT ITEMS 1/2
20 20 20 20 20 20 20 20 00
20 20 20 20 20 20 20 00 20
20 20 20 20 20 20 00 20 20
20 20 20 20 20 00 20 20 20
20 20 20 20 00 20 20 20 20
20 20 20 00 20 20 20 20 20
20 20 00 20 20 20 20 20 20
20 00 20 20 20 20 20 20 20
00 20 20 20 20 20 20 20 20