MODE 0
SIZE 9/11
LIMIT 0/30
COLOR LIMIT 5
STARS 3500/4100/4900
COLLECT COUNT 0/0
COLLECT ITEMS 0/0
10 10 10 10 10 10 10 10 10
10 10 10 10 10 10 10 10 10
10 10 10 10 10 10 10 10 10
10 10 10 10 10 10 10 10 10
10 10 10 10 10 10 10 10 10
10 10 10 10 13 10 10 10 10
10 10 10 13 14 13 10 10 10
10 10 13 14 14 14 13 10 10
10 13 14 14 14 14 14 13 10
13 14 14 14 14 14 14 14 13
14 14 14 14 14 14 14 14 14