MODE 3
SIZE 9/11
LIMIT 0/48
COLOR LIMIT 6
STARS 10000/14000/18000
COLLECT COUNT 0/0
COLLECT ITEMS 0/0
10 10 10 10 10 10 10 10 10
10 10 10 10 10 10 10 10 10
10 23 23 23 10 23 23 23 10
10 23 23 23 10 23 23 23 10
10 23 23 23 10 23 23 23 10
10 10 10 10 10 10 10 10 10
10 10 10 10 10 10 10 10 10
10 23 23 23 10 23 23 23 10
10 23 23 23 10 23 23 23 10
10 23 23 23 10 23 23 23 10
10 10 10 10 10 10 10 10 10