MODE 2
SIZE 9/9
LIMIT 0/27
COLOR LIMIT 4
STARS 4200/5600/8900
COLLECT COUNT 2/2
COLLECT ITEMS 1/2
10 10 10 10 10 10 10 10 10
10 10 10 10 10 10 10 10 10
10 10 10 10 10 10 10 10 10
14 14 14 14 14 14 14 14 14
10 10 10 10 10 10 10 10 10
14 14 14 14 14 14 14 14 14
13 13 13 13 13 13 13 13 13
00 14 14 14 14 14 14 14 00
00 00 13 13 13 13 13 00 00