MODE 0
SIZE 8/10
LIMIT 0/16
COLOR LIMIT 5
STARS 800/1100/1400
COLLECT COUNT 0/0
COLLECT ITEMS 0/0
00 10 10 10 10 10 10 00
00 10 10 10 10 10 10 00
10 10 10 10 10 10 10 10
10 10 10 10 10 10 10 10
10 10 10 10 10 10 10 10
10 10 10 10 10 10 10 10
10 10 10 10 10 10 10 10
10 10 10 10 10 10 10 10
00 10 10 10 10 10 10 00
00 10 10 10 10 10 10 00