MODE 3
SIZE 9/9
LIMIT 0/33
COLOR LIMIT 5
STARS 5900/6800/9700
COLLECT COUNT 0/0
COLLECT ITEMS 1/2
10 10 10 10 10 10 10 10 14
10 10 10 10 10 10 10 14 14
10 10 10 10 10 10 14 14 14
10 10 10 10 10 14 14 14 14
10 10 10 10 14 14 14 14 14
10 10 10 14 14 14 14 14 14
10 10 14 14 14 14 14 14 14
10 14 14 14 14 14 14 14 14
14 14 14 14 14 14 14 14 50