MODE 3
SIZE 9/11
LIMIT 0/25
COLOR LIMIT 4
STARS 8500/9600/11200
COLLECT COUNT 0/0
COLLECT ITEMS 1/2
00 00 00 10 10 10 00 00 00
00 00 10 10 10 10 10 00 00
00 10 10 10 53 10 10 10 00
10 10 10 53 20 53 10 10 10
10 10 53 20 50 20 53 10 10
10 53 20 50 50 50 20 53 10
10 10 53 20 50 20 53 10 10
10 10 10 53 20 53 10 10 10
00 10 10 10 53 10 10 10 00
00 00 10 10 10 10 10 00 00
00 00 00 10 10 10 00 00 00