MODE 2
SIZE 9/9
LIMIT 0/42
COLOR LIMIT 5
STARS 3900/4600/5800
COLLECT COUNT 2/2
COLLECT ITEMS 1/2
10 10 10 10 10 10 10 10 10
10 10 10 10 10 10 10 10 10
10 10 10 10 10 10 10 10 10
10 10 10 10 10 10 10 10 10
10 10 10 10 10 10 10 10 10
14 14 14 14 14 14 14 14 14
13 13 13 13 13 13 13 13 13
10 10 13 14 14 14 13 10 10
10 10 10 13 13 13 10 10 10