MODE 1
SIZE 9/10
LIMIT 0/25
COLOR LIMIT 5
STARS 7500/10000/13000
COLLECT COUNT 20/25
COLLECT ITEMS 3/5
13 20 20 20 20 20 20 20 13
20 13 20 20 20 20 20 13 20
20 20 13 20 20 20 13 20 20
20 20 20 13 20 13 20 20 20
20 20 20 20 13 20 20 20 20
20 20 20 20 13 20 20 20 20
20 20 20 13 20 13 20 20 20
20 20 13 20 20 20 13 20 20
20 13 20 20 20 20 20 13 20
13 20 20 20 20 20 20 20 13