MODE 3
SIZE 9/10
LIMIT 0/23
COLOR LIMIT 4
STARS 10000/12500/14000
COLLECT COUNT 0/0
COLLECT ITEMS 1/2
50 50 50 14 50 14 50 50 50
50 50 50 14 50 14 50 50 50
50 50 50 14 50 14 50 50 50
14 14 14 14 50 14 14 14 14
20 20 20 14 50 14 20 20 20
20 20 20 14 50 14 20 20 20
20 20 20 14 50 14 20 20 20
20 20 20 14 50 14 20 20 20
20 20 20 14 50 14 20 20 20
20 20 20 14 50 14 20 20 20