MODE 1
SIZE 9/9
LIMIT 0/20
COLOR LIMIT 4
STARS 2200/3200/4500
COLLECT COUNT 15/15
COLLECT ITEMS 1/4
00 10 10 10 10 10 10 10 00
00 14 13 13 13 13 13 14 00
00 00 10 10 10 10 10 00 00
00 14 10 10 10 10 10 14 00
00 00 10 10 10 10 10 00 00
00 14 13 13 13 13 13 14 00
50 50 50 50 50 50 50 50 50
50 50 50 50 50 50 50 50 50
50 50 50 50 50 50 50 50 50