MODE 3
SIZE 9/9
LIMIT 0/12
COLOR LIMIT 5
STARS 1500/2900/3600
COLLECT COUNT 0/0
COLLECT ITEMS 1/2
10 10 10 10 00 10 10 10 10
10 10 10 10 00 10 10 10 10
10 10 13 13 13 13 13 10 10
10 10 13 13 13 13 13 10 10
00 00 13 13 00 13 13 00 00
10 10 13 13 13 13 13 10 10
10 10 13 13 13 13 13 10 10
10 10 10 10 00 10 10 10 10
10 10 10 10 00 10 10 10 10