MODE 0
SIZE 8/11
LIMIT 0/21
COLOR LIMIT 5
STARS 1000/1500/1900
COLLECT COUNT 0/0
COLLECT ITEMS 0/0
00 10 10 10 10 10 10 00
10 10 10 10 10 10 10 10
10 10 10 10 10 10 10 10
10 10 10 10 10 10 10 10
00 10 10 10 10 10 10 00
00 10 10 10 10 10 10 00
10 10 10 10 10 10 10 10
10 10 10 10 10 10 10 10
10 10 10 10 10 10 10 10
10 10 10 10 10 10 10 10
00 10 10 00 00 10 10 00