MODE 3
SIZE 9/8
LIMIT 0/30
COLOR LIMIT 4
STARS 9800/11300/13500
COLLECT COUNT 0/0
COLLECT ITEMS 0/0
10 50 50 50 00 20 20 20 10
50 53 53 50 23 20 23 23 20
50 53 53 50 23 20 23 23 20
50 50 50 50 23 20 20 20 20
00 50 50 50 13 20 20 20 00
00 00 50 50 13 20 20 00 00
00 00 00 50 13 20 00 00 00
00 00 00 00 13 00 00 00 00