MODE 3
SIZE 9/11
LIMIT 0/28
COLOR LIMIT 5
STARS 3400/6500/10000
COLLECT COUNT 0/0
COLLECT ITEMS 1/2
10 10 10 10 10 10 10 10 10
10 10 10 10 10 10 10 10 10
10 10 10 10 10 10 10 10 10
10 10 10 10 10 10 10 10 10
14 14 14 14 14 14 14 14 14
14 14 14 14 14 14 14 14 14
14 14 17 17 17 17 17 14 14
14 14 17 10 10 10 17 14 14
14 14 17 10 53 10 17 14 14
14 14 17 10 10 10 17 14 14
14 14 17 17 17 17 17 14 14