MODE 3
SIZE 9/11
LIMIT 0/28
COLOR LIMIT 4
STARS 2500/5000/6100
COLLECT COUNT 0/0
COLLECT ITEMS 0/0
10 10 10 10 10 10 10 10 10
10 10 10 10 10 10 10 10 10
10 10 10 10 10 10 10 10 10
10 10 10 10 10 10 10 10 10
10 10 10 10 10 10 10 10 10
00 00 00 00 00 00 00 00 00
23 10 23 10 23 10 23 10 23
10 23 10 23 10 23 10 23 10
23 10 23 10 23 10 23 10 23
10 23 10 23 10 23 10 23 10
23 17 23 17 23 17 23 17 23