MODE 1
SIZE 9/9
LIMIT 0/30
COLOR LIMIT 5
STARS 2900/3600/4800
COLLECT COUNT 25/25
COLLECT ITEMS 3/5
17 10 10 10 10 10 10 10 17
10 10 10 10 10 10 10 10 10
10 10 13 10 10 10 13 10 10
10 10 10 13 13 13 10 10 10
13 13 13 13 13 13 13 13 13
14 14 14 17 17 17 14 14 14
10 10 14 10 10 10 14 10 10
10 10 14 10 10 10 14 10 10
17 10 10 17 10 17 10 10 17