MODE 0
SIZE 9/11
LIMIT 0/30
COLOR LIMIT 5
STARS 3100/4500/6800
COLLECT COUNT 0/0
COLLECT ITEMS 1/2
17 10 10 13 00 13 10 10 17
17 10 10 13 00 13 10 10 17
17 10 10 13 00 13 10 10 17
17 10 10 13 00 13 10 10 17
17 10 10 13 00 13 10 10 17
17 10 10 13 00 13 10 10 17
17 10 10 13 13 13 10 10 17
17 10 10 10 10 10 10 10 17
17 10 14 10 10 10 14 10 17
17 10 10 10 10 10 10 10 17
17 17 17 17 17 17 17 17 17