MODE 2
SIZE 9/11
LIMIT 0/35
COLOR LIMIT 4
STARS 2500/3800/5600
COLLECT COUNT 2/2
COLLECT ITEMS 1/2
10 10 10 10 10 10 10 10 10
10 10 10 10 10 10 10 10 10
10 10 10 10 10 10 10 10 10
10 10 10 10 10 10 10 10 10
14 00 10 10 10 10 10 00 14
10 00 00 00 17 00 00 00 10
10 00 00 00 17 00 00 00 10
10 00 10 10 10 10 10 00 10
10 10 10 10 10 10 10 10 10
10 10 10 10 10 10 10 10 10
10 10 10 10 10 10 10 10 10