MODE 1
SIZE 9/11
LIMIT 0/36
COLOR LIMIT 5
STARS 2300/4500/6550
COLLECT COUNT 25/35
COLLECT ITEMS 1/2
00 00 10 10 10 10 10 00 00
00 10 10 10 10 10 10 10 00
00 13 13 13 13 13 13 13 00
13 20 20 20 13 20 20 20 13
13 20 00 20 13 20 00 20 13
13 20 20 20 13 20 20 20 13
13 13 13 13 13 13 13 13 13
10 10 10 10 10 10 10 10 10
10 10 10 10 10 10 10 10 10
10 10 10 10 10 10 10 10 10
00 00 00 17 17 17 00 00 00