MODE 0
SIZE 8/11
LIMIT 0/25
COLOR LIMIT 4
STARS 5500/7200/8500
COLLECT COUNT 0/0
COLLECT ITEMS 1/2
00 00 00 00 00 00 00 00
00 00 00 00 00 00 00 00
10 10 10 10 10 10 10 10
10 14 14 14 14 14 10 10
10 14 16 14 16 14 10 10
10 14 14 14 14 14 10 10
13 13 13 13 13 13 13 13
10 10 14 14 14 14 14 10
10 10 14 16 14 16 14 10
10 10 14 14 14 14 14 10
10 10 10 10 10 10 10 10