MODE 3
SIZE 9/10
LIMIT 0/25
COLOR LIMIT 4
STARS 3500/5500/7200
COLLECT COUNT 0/0
COLLECT ITEMS 1/2
00 00 00 00 00 00 00 00 00
00 00 10 10 10 10 10 00 00
00 10 50 24 24 24 50 10 00
00 10 24 20 20 20 24 10 00
00 10 24 20 20 20 24 10 00
00 10 24 20 20 20 24 10 00
00 10 24 20 20 20 24 10 00
00 10 24 20 20 20 24 10 00
00 10 50 24 24 24 50 10 00
00 00 10 10 10 10 10 00 00