MODE 3
SIZE 9/7
LIMIT 1/25
COLOR LIMIT 5
STARS 1200/1500/2000
COLLECT COUNT 0/0
COLLECT ITEMS 1/2
10 10 10 10 10 10 10 10 10
10 10 20 20 20 20 20 10 10
10 10 20 20 20 20 20 10 10
10 10 20 20 20 20 20 10 10
10 10 20 20 20 20 20 10 10
10 10 10 10 10 10 10 10 10
10 10 10 10 10 10 10 10 10