MODE 3
SIZE 9/11
LIMIT 0/43
COLOR LIMIT 5
STARS 7000/9000/10000
COLLECT COUNT 0/0
COLLECT ITEMS 1/2
10 10 10 10 13 10 10 10 10
10 10 10 10 13 10 10 10 10
10 10 10 10 13 10 10 10 10
10 10 10 10 13 10 10 10 10
10 14 13 14 13 14 13 14 10
10 13 14 50 14 50 14 13 10
10 14 50 50 50 50 50 14 10
10 13 14 50 50 50 14 13 10
10 14 13 14 50 14 13 14 10
10 13 14 13 14 13 14 13 10
10 10 10 10 10 10 10 10 10