MODE 3
SIZE 9/11
LIMIT 0/51
COLOR LIMIT 5
STARS 8300/15000/28000
COLLECT COUNT 0/0
COLLECT ITEMS 1/2
10 10 10 00 10 10 10 20 17
20 20 20 00 10 10 10 20 17
20 20 20 00 10 10 10 20 20
20 20 20 00 10 10 10 20 20
20 20 20 00 10 10 10 20 17
20 20 20 00 10 10 10 20 17
20 20 20 00 10 10 10 20 17
20 20 20 00 10 10 10 20 20
20 20 20 00 10 10 10 20 20
20 20 20 00 10 10 10 20 17
10 10 10 00 10 10 10 20 17