MODE 3
SIZE 9/9
LIMIT 0/30
COLOR LIMIT 3
STARS 1000/2500/3800
COLLECT COUNT 0/0
COLLECT ITEMS 0/0
24 20 24 24 00 24 24 20 24
20 20 20 20 00 24 24 20 20
24 24 24 24 00 24 24 20 20
24 24 24 24 00 24 24 20 24
00 00 00 00 00 00 00 00 00
24 24 24 24 00 24 24 20 24
24 24 24 24 00 24 24 20 24
24 24 24 24 00 24 24 20 24
24 24 24 24 00 24 24 20 24