MODE 2
SIZE 9/11
LIMIT 0/37
COLOR LIMIT 5
STARS 4900/5600/8300
COLLECT COUNT 1/1
COLLECT ITEMS 1/2
10 10 10 10 10 10 10 10 10
10 10 10 10 10 10 10 10 10
10 10 10 14 14 14 10 10 10
10 10 10 14 13 14 10 10 10
10 10 10 14 14 14 10 10 10
10 10 10 10 10 10 10 10 10
00 10 10 10 10 10 10 10 00
00 00 10 10 10 10 10 00 00
00 00 00 13 13 13 00 00 00
10 10 14 14 14 14 14 10 10
14 14 14 14 00 14 14 14 14