MODE 0
SIZE 9/9
LIMIT 0/13
COLOR LIMIT 3
STARS 7800/8300/10200
COLLECT COUNT 0/0
COLLECT ITEMS 1/2
10 50 50 50 50 50 50 50 10
00 10 50 50 50 50 50 10 00
14 00 10 50 50 50 10 00 14
00 14 00 50 50 50 00 14 00
14 00 14 00 14 00 14 00 14
00 14 00 50 50 50 00 14 00
14 00 10 50 50 50 10 00 14
00 10 50 50 50 50 50 10 00
10 50 50 50 50 50 50 50 10