MODE 2
SIZE 9/9
LIMIT 0/28
COLOR LIMIT 4
STARS 1000/2500/3800
COLLECT COUNT 4/4
COLLECT ITEMS 1/2
10 10 10 10 10 10 10 10 10
10 50 50 50 50 50 50 50 10
10 50 50 50 50 50 50 50 10
10 50 10 50 10 50 10 50 10
00 50 00 50 00 50 00 50 00
10 50 10 50 10 50 10 50 10
10 50 50 50 50 50 50 50 10
10 50 50 50 50 50 50 50 10
10 10 10 10 10 10 10 10 10