MODE 3
SIZE 9/9
LIMIT 0/37
COLOR LIMIT 4
STARS 9000/11000/13000
COLLECT COUNT 0/0
COLLECT ITEMS 1/2
10 10 10 10 00 10 10 10 10
10 10 10 10 00 10 10 10 10
10 10 10 10 00 10 10 10 10
10 10 10 10 00 10 10 10 10
10 10 10 10 00 10 10 10 10
13 13 13 13 13 13 13 13 13
50 50 50 50 50 50 50 50 50
50 50 50 50 50 50 50 50 50
50 50 50 50 50 50 50 50 50