MODE 2
SIZE 9/9
LIMIT 0/36
COLOR LIMIT 5
STARS 2200/3900/5950
COLLECT COUNT 1/2
COLLECT ITEMS 1/2
10 10 10 00 00 00 10 10 10
10 10 10 00 10 00 10 10 10
10 10 10 10 10 10 10 10 10
00 10 10 10 10 10 10 10 00
10 10 10 10 10 10 10 10 10
00 10 10 10 10 10 10 10 00
10 10 10 10 10 10 10 10 10
10 10 10 10 10 10 10 10 10
10 10 10 10 10 10 10 10 10