MODE 1
SIZE 9/9
LIMIT 0/29
COLOR LIMIT 5
STARS 2150/4800/6900
COLLECT COUNT 20/25
COLLECT ITEMS 1/2
10 10 10 10 10 10 10 10 10
00 10 10 10 10 10 10 10 00
10 00 10 10 10 10 10 00 10
10 10 00 10 10 10 00 10 10
10 10 10 00 10 00 10 10 10
10 10 10 10 10 10 10 10 10
10 10 10 10 00 10 10 10 10
13 13 10 10 00 10 10 13 13
13 13 10 10 00 10 10 13 13