MODE 0
SIZE 9/9
LIMIT 0/15
COLOR LIMIT 4
STARS 2500/6800/9800
COLLECT COUNT 0/0
COLLECT ITEMS 1/2
10 10 10 10 14 10 10 10 10
10 10 10 10 14 10 10 10 10
10 10 10 10 14 14 14 14 14
10 10 10 10 00 10 10 10 10
00 00 10 10 00 10 10 00 00
10 10 10 10 00 10 10 10 10
10 10 10 10 00 10 10 10 10
10 10 10 10 00 10 10 10 10
10 10 10 10 00 10 10 10 10