MODE 3
SIZE 8/11
LIMIT 0/15
COLOR LIMIT 4
STARS 1500/2000/2300
COLLECT COUNT 0/0
COLLECT ITEMS 0/0
10 10 00 00 00 00 10 10
10 10 10 10 10 10 10 10
10 10 10 10 10 10 10 10
10 10 10 10 10 10 10 10
10 10 10 10 10 10 10 10
10 10 10 10 10 10 10 10
10 10 10 10 10 10 10 10
10 10 10 10 10 10 10 10
10 00 10 10 10 10 00 10
10 10 10 10 10 10 10 10
00 00 10 10 10 10 00 00