MODE 0
SIZE 9/9
LIMIT 0/30
COLOR LIMIT 5
STARS 1500/4800/6500
COLLECT COUNT 0/0
COLLECT ITEMS 1/2
00 00 10 10 10 10 10 00 00
00 10 10 10 10 10 10 10 00
10 10 10 10 10 10 10 10 10
00 10 10 10 10 10 10 10 00
00 00 14 14 14 14 14 00 00
00 00 00 20 20 20 00 00 00
00 00 20 20 20 20 20 00 00
00 00 00 20 20 20 00 00 00
00 00 00 00 20 00 00 00 00