MODE 2
SIZE 9/10
LIMIT 0/35
COLOR LIMIT 5
STARS 2300/4300/6500
COLLECT COUNT 2/1
COLLECT ITEMS 1/2
00 10 10 10 14 10 10 10 00
10 10 10 10 14 10 10 10 10
10 10 10 10 14 10 10 10 10
10 16 10 10 14 10 10 16 10
10 10 10 10 14 10 10 10 10
10 10 16 10 14 10 16 10 10
00 10 10 10 14 10 10 10 00
00 13 13 13 13 13 13 13 00
10 10 10 10 10 10 10 10 10
10 10 10 10 10 10 10 10 10