MODE 0
SIZE 9/11
LIMIT 0/20
COLOR LIMIT 5
STARS 3500/4800/6200
COLLECT COUNT 0/0
COLLECT ITEMS 1/2
10 00 10 10 10 10 10 00 10
10 10 00 10 10 10 00 10 10
10 10 10 00 14 00 10 10 10
10 10 10 10 00 10 10 10 10
24 24 24 24 50 24 24 24 24
24 24 24 50 50 50 24 24 24
24 24 24 24 50 24 24 24 24
10 10 10 10 00 10 10 10 10
10 10 10 00 14 00 10 10 10
00 10 00 10 10 10 00 10 00
00 00 10 10 10 10 10 00 00