MODE 1
SIZE 9/11
LIMIT 0/18
COLOR LIMIT 5
STARS 2200/3500/5900
COLLECT COUNT 25/30
COLLECT ITEMS 1/4
14 10 10 10 00 10 10 10 14
14 14 14 14 00 10 10 10 14
00 00 00 10 10 10 10 10 14
14 10 10 10 10 10 14 14 14
14 10 10 10 10 10 10 00 00
14 14 14 10 00 10 10 10 14
00 00 10 10 10 10 10 10 14
14 10 10 10 10 14 14 14 14
14 10 10 10 10 10 00 00 00
14 10 10 10 00 10 10 10 14
14 14 14 14 00 14 14 14 14