MODE 2
SIZE 9/11
LIMIT 0/23
COLOR LIMIT 4
STARS 2500/6800/12000
COLLECT COUNT 3/5
COLLECT ITEMS 1/2
00 00 10 10 10 10 10 00 00
00 00 00 10 10 10 00 00 00
20 20 00 10 10 10 00 20 20
20 20 10 10 10 10 10 20 20
20 20 10 10 10 10 10 20 20
20 20 10 10 10 10 10 20 20
20 20 10 10 10 10 10 20 20
20 20 10 10 10 10 10 20 20
20 20 10 10 10 10 10 20 20
20 20 00 10 10 10 00 20 20
00 00 00 10 10 10 00 00 00