MODE 3
SIZE 9/11
LIMIT 0/38
COLOR LIMIT 5
STARS 2500/3600/7800
COLLECT COUNT 0/0
COLLECT ITEMS 0/0
10 10 10 10 10 10 10 10 10
10 10 10 10 10 10 10 10 10
00 13 00 14 10 14 00 13 00
00 13 00 14 10 14 00 13 00
00 13 00 14 10 14 00 13 00
00 13 00 14 10 14 00 13 00
00 13 00 14 10 14 00 13 00
00 13 00 14 10 14 00 13 00
50 13 50 14 10 14 50 13 50
50 50 50 50 50 50 50 50 50
50 50 50 50 50 50 50 50 50