MODE 3
SIZE 9/9
LIMIT 0/31
COLOR LIMIT 4
STARS 5000/8900/15000
COLLECT COUNT 0/0
COLLECT ITEMS 1/2
00 00 10 20 20 20 10 00 00
00 10 20 50 50 50 20 10 00
10 20 20 20 50 20 20 20 10
20 50 20 00 50 00 20 50 20
20 50 00 20 20 20 00 50 20
20 50 20 00 50 00 20 50 20
10 20 20 20 50 20 20 20 10
00 10 20 50 50 50 20 10 00
00 00 10 20 20 20 10 00 00