MODE 1
SIZE 9/9
LIMIT 0/29
COLOR LIMIT 4
STARS 8000/12000/13000
COLLECT COUNT 20/20
COLLECT ITEMS 1/4
20 50 20 00 00 00 00 00 00
20 50 20 14 14 14 00 00 00
20 50 20 14 23 14 14 14 00
20 50 20 14 23 14 23 14 00
20 50 20 14 23 14 23 14 00
20 50 20 14 23 14 23 14 00
20 50 20 14 23 14 14 14 00
20 50 20 14 14 14 00 00 00
20 50 20 00 00 00 00 00 00