MODE 0
SIZE 9/11
LIMIT 0/30
COLOR LIMIT 5
STARS 6800/10200/15000
COLLECT COUNT 0/0
COLLECT ITEMS 1/2
10 10 10 14 14 14 10 10 10
10 10 10 14 00 14 10 10 10
13 10 10 14 00 14 10 10 13
10 13 10 14 14 14 10 13 10
00 10 13 10 10 10 13 10 00
00 10 10 13 10 13 10 10 00
10 10 10 14 14 14 10 10 10
10 10 10 14 14 14 10 10 10
10 00 00 14 14 14 00 00 10
10 10 14 14 14 14 14 10 10
10 14 14 14 14 14 14 14 10