MODE 2
SIZE 9/9
LIMIT 0/35
COLOR LIMIT 5
STARS 7300/8000/10000
COLLECT COUNT 2/1
COLLECT ITEMS 1/2
20 10 24 10 53 10 24 10 20
20 10 24 10 53 10 24 10 20
20 10 24 10 53 10 24 10 20
20 10 24 10 53 10 24 10 20
00 00 00 10 53 10 00 00 00
20 10 24 10 53 10 24 10 20
20 10 24 10 53 10 24 10 20
20 10 24 10 53 10 24 10 20
20 10 24 10 53 10 24 10 20