MODE 3
SIZE 9/10
LIMIT 0/28
COLOR LIMIT 5
STARS 9500/18000/24300
COLLECT COUNT 0/0
COLLECT ITEMS 1/2
00 10 10 10 00 10 10 10 00
10 50 50 50 14 50 50 50 10
00 50 50 50 14 50 50 50 00
10 50 50 50 14 50 50 50 10
00 10 10 00 00 00 10 10 00
00 10 10 00 00 00 10 10 00
10 50 50 50 14 50 50 50 10
00 50 50 50 14 50 50 50 00
10 50 50 50 14 50 50 50 10
00 10 10 10 00 10 10 10 00