MODE 1
SIZE 9/10
LIMIT 0/16
COLOR LIMIT 4
STARS 2300/5300/8600
COLLECT COUNT 45/45
COLLECT ITEMS 2/5
00 00 00 00 00 10 10 10 10
10 00 00 00 00 10 10 10 10
10 10 00 00 00 10 10 10 10
10 10 10 00 00 10 10 10 10
10 10 10 10 00 00 00 00 00
10 10 10 10 14 00 00 00 00
10 10 10 14 10 10 00 00 00
10 10 14 10 10 10 10 00 00
10 14 10 10 10 10 10 10 00
14 10 10 10 10 10 10 10 10