MODE 2
SIZE 9/9
LIMIT 0/22
COLOR LIMIT 4
STARS 2600/5800/9300
COLLECT COUNT 1/1
COLLECT ITEMS 1/2
10 10 10 10 00 10 10 10 10
50 50 50 50 50 50 50 50 50
50 50 50 50 50 50 50 50 50
50 50 50 50 50 50 50 50 50
00 10 00 10 00 10 00 10 00
10 00 10 00 10 00 10 00 10
50 50 50 50 50 50 50 50 50
50 50 50 50 50 50 50 50 50
50 50 50 50 50 50 50 50 50