MODE 0
SIZE 9/9
LIMIT 0/25
COLOR LIMIT 5
STARS 8200/10400/13600
COLLECT COUNT 0/0
COLLECT ITEMS 1/2
10 10 10 10 00 10 10 10 10
10 20 20 20 20 20 20 20 10
10 20 20 20 20 20 20 20 10
10 20 20 20 00 20 20 20 10
00 20 20 20 00 20 20 20 00
00 20 20 20 00 20 20 20 00
00 20 20 20 00 20 20 20 00
00 20 20 20 20 20 20 20 00
00 20 20 20 20 20 20 20 00