MODE 0
SIZE 9/9
LIMIT 0/17
COLOR LIMIT 4
STARS 1500/1900/3200
COLLECT COUNT 0/0
COLLECT ITEMS 0/0
00 00 00 00 00 00 14 20 00
20 20 20 20 20 20 14 20 00
14 14 14 14 14 14 14 20 00
00 20 14 50 50 50 14 20 00
00 20 14 50 14 50 14 20 00
00 20 14 50 50 50 14 20 00
00 20 14 14 14 14 14 14 14
00 20 14 20 20 20 20 20 20
00 20 14 00 00 00 00 00 00