MODE 1
SIZE 9/9
LIMIT 0/29
COLOR LIMIT 5
STARS 2600/5600/7500
COLLECT COUNT 30/30
COLLECT ITEMS 1/4
10 10 10 10 50 10 10 10 10
10 10 10 14 50 14 10 10 10
10 10 10 14 50 14 10 10 10
14 14 14 14 50 14 14 14 14
50 50 50 50 50 50 50 50 50
10 14 14 14 14 14 14 14 10
10 14 20 20 20 20 20 14 10
10 14 20 14 14 14 20 14 10
00 00 14 14 14 14 14 00 00